	eng	kor
Attack	Attack	공격
Skill	Skill	스킬
Item	Item	아이템
Stay	Stay	대기
Cancle	Cancle	취소
NormalAttack_Melee	NormalAttack - Melee	일반공격 - 근접
desc_NormalAttack_Melee	Using an weapon to melee attack.	무기를 이용한 근접공격
NormalAttack_Spear	NormalAttack - Range	일반공격 - 원거리
desc_NormalAttack_Spear	Using an spear to melee attack.	창을 이용한 근접공격
NormalAttack_Range	NormalAttack - Range	일반공격 - 원거리
desc_NormalAttack_Range	Using an weapon to range attack.	무기를 이용한 원거리 공격
NormalAttack_Ryeon	NormalAttack - Ryeon	일반공격 - 원거리
desc_NormalAttack_Ryeon	Using an Ryeon to attack.	연을 이용한 공격
Test_Sword	Test Sword	테스트용 검
desc_Test_Sword	Test Weapon, Sword.	테스트 무기, 검.
WoodenSword	Wooden Sword	목검
desc_WoodenSword	A Wooden Sword.	나무로 만들어진 검.
IronSword	Iron Sword	철검
desc_IronSword	A Iron Sword.	철로 만들어진 검.
FireSword	Fire Sword	불의 검
desc_FireSword	Flame forced sword./n'Fire Element' <val0>	불의 힘을 지닌 검./n화염 속성<val0>
RoseThorn	Rose Thorn	장미의 가시
desc_RoseThorn	The moment you're fascinated, you're stabbed by a thorn/nPoison <val0>, Bleed <val1>	매료된 순간 가시에 찔리게된다/n독 <val0>, 출혈 <val1>
TheNeedleOfFate	The Needle of Fate	운명의 바늘
desc_TheNeedleOfFate	The needle through fate/nIf you deal with enemies with less than <val0>% your hp, you will get a fate buff (move to buff position during hit, delete buff if not movable) for <val1>T	운명과 운명을 꿰는 바늘/nHP이 <val0>% 이하인 상태에서 적 처치시 운명(피격시 버프 획득 위치로 이동, 이동 불가시 버프 삭제)버프를 <val1>턴간 획득
RevolvingBlade	Revoloving Blade	회전칼날
desc_RevolvingBlade	A blade that spins at high speed/nIf you attack it, Speed increases by <val0>, Up to <val1> overlapping	고속으로 회전하는 칼날/n 공격시 속도 <val0>증가, 최대 <val1> 중첩 가능
ColoredBlack	Colored Black	근묵자흑
desc_ColoredBlack	Dye it black./n<val0>% chance of 'Weakness' for <val1> turn.	검게 물들여라/n<val0>%확률로 <val1>턴간 쇠약부여
WoodenSpear	Wooden Spear	나무 창
desc_WoodenSpear	A Wooden Spear	나무로 만든 창
IronSpear	Iron Spear	철의 창
desc_IronSpear	A Iron Spear	철로 만든 창
LightningGodsSpear	LightningGod's Spear	뇌신의 창
desc_LightningGodsSpear	The spear used by the lightning god in the myth/n'Lightning Element' <val0>	신화에 기록된 뇌신이 사용하던 창/n번개 속성 <val0>
DemonArm	Demon Arm	악령의 팔
desc_DemonArm	The spear made of demonic arms/n<val0>% chance of 'Fear' for <val1> turn	악령의 팔로 만든 창./n<val0>%확률로 <val1>턴간 공포를 부여한다.
GigantSpear	Gigant Spear	거인의 창
desc_GigantSpear	The Giant Spear	거대한 창
CrystalSpear	Crystal Spear	크리스탈 창
desc_CrystalSpear	The Spear made of crystal/nInflict Ryeon damage.	크리스탈로 만든 창/n연술피해를 입힌다.
AshSpike	Ash Spike	잿빛 가시
desc_AshSpike	The spear with heat remaining/n'Fire Element' <val0>	열기가 남아있는 가시 창/n화염 속성<val0>.
WoodenClub	Wooden Club	나무 몽둥이
desc_WoodenClub	A Wooden Club	나무로 만든 몽둥이
IronAxe	Iron Axe	철의 도끼
desc_IronAxe	A Iron Axe	철로 만든 도끼
FishbowlStick	Fishbowl Stick	어항 막대
desc_FishbowlStick	The Fishbowl is weapon/n'Water Element' <val0>.	무기로 삼아진 어항/n물 속성 <val0>.
GeradonsAxe	Geradon's Axe	게라돈의 도끼
desc_GeradonsAxe	The weapon has given by the Geradon, Stone Spirit./n 'Earth Element' <val0>.	바위정령 게라돈이 선물해준 무기/n대지 속성 <val0>.
BigIcicle	Big Icicle	거대 고드름
desc_BigIcicle	It is very cold/n'Frost Element' <val0>	너무도 차갑다/n냉기 속성 <val0>
GiantDeersHorn	Giant Deer's Horn	거록의 뿔
desc_GiantDeersHorn	The Horn of the giant deer	몹시 거대한 순록의 뿔
WoodenStaff	Wooden Staff	나무 막대
desc_WoodenStaff	A Wooden Staff/nGet Ryeon 「Photosynthesis」	나무로 만든 막대/n「광합성」 연술 추가
ALazyMorning	A Lazy Morning	게으른 자의 아침
desc_ALazyMorning	A Slow starter/n<val0>% chance to reduce target mobility by <val1>	느릿하게 시작하는 자/n<val0>%확률로 대상의 이동력 <val1> 감소
BurningStick	Burning Stick	불타는 막대
desc_BurningStick	The Burning Stick/nGet Ryeon 「Fire Arrow」	불타는 막대/n「불화살」 연술 추가
ThePillarOfVerdure	The Pillar of Verdure	신록의 기둥
desc_ThePillarOfVerdure	The Blessing of nature and mana/nIf you hitted by fire element, give your melee attack fire element	자연과 마나의 축복/n화염 속성으로 피격시 다음 근접 공격 화염 속성 부여
EducationStick	Education Stick	가르침의 막대
desc_EducationStick	Teacher's Kindness/nIf your melee attack made target's hp less than <val0>%, give target stun during <val1>turn	스승의 은혜/n근접공격으로 대상의 HP이 <val0>% 미만이 될 경우 <val1>턴간 기절 부여
MilleniumRock	Millenium Rock	천년바위
desc_MilleniumRock	The firmness of time/nIncrease Def, Res <val0>	굳센 세월의 단단함/n방어력, 저항력 <val0> 증가
TrainingBow	Training Bow	훈련용 활
desc_TrainingBow	The Training Bow	훈련에 쓰이는 활
IronBow	Iron Bow	철의 활
desc_IronBow	The Iron Bow	철로 만든 활
FrostCrystal	Frost Crystal	서리결정
desc_FrostCrystal	A chilling chill/n'Frost Element' <val0>	오싹한 냉기/n냉기 속성 <val0>
TheZephyros	The Zephyros	서풍의 활
desc_TheZephyros	The Trajectory is blowed with a far western wind/n'Wind Element' <val0>, Range Bonus <val1>	멀리서 서풍과 함께 불어온 궤적/n바람 속성 <val0>, 사정거리 <val1>증가
Typhoon	Typhoon	태풍
desc_Typhoon	An arrow that shoots like a storm/nRange Bonus <val0>	몰아치는 태풍처럼 쏘아지는 화살/n사정거리 <val0>증가
SplitBow	Split Bow	갈래 활
desc_SplitBow	A Split Bow/nGet Attack Skill 「Arrow Rain」	갈라진 활/n「화살비」 전투기술 추가
SapphireOrb	Sapphire Orb	사파이어 보주
desc_SapphireOrb	A Sapphire Orb/nGet Ryeon 「Crystal Arrow」	사파이어가 새겨진 보주/n「결정 화살」 연술 추가
RubyOrb	Ruby Orb	루비 보주
desc_RubyOrb	A Ruby Orb/nGet Ryeon 「Fire Arrow」	루비가 새겨진 보주/n「불화살」 연술 추가
WhiteOrb	White Orb	화이트 보주
desc_WhiteOrb	A White Orb/nGet Ryeon 「Wind」	새하얀 보주/n「윈드」 연술 추가
SparkGlass	Spark Glass	스파크 글래스
desc_SparkGlass	Sparked Glass Orb/nGet Ryeon 「Chain Lightning」	스파크가 흐르는 유리 보주/n「체인 라이트닝」 연술 추가
FlowerOfStar	Flower Of Star	별의 꽃
desc_FlowerOfStar	Beautiful and Brilliant The flower of the star/nGet Ryeon 「Falling Star」	아름답고도 눈부신 별의 꽃/n「별빛 낙하」 연술 추가
GloryAndFaith	Glory and Faith	영광과 믿음
desc_GloryAndFaith	If enemies are coming, trust yourself/nIn Enemy Turn, Get Ryeon Drain <val0>%	적이 몰려올지라도 자신을 믿으리라/n적군의 턴일시 연술흡혈 <val0>% 획득
RedEye	Red Eye	붉은 눈
desc_RedEye	Floating silent red eye in sky/nIn outdoor, Every enemies are decreased resistance <val0>%	하늘을 떠다니는 고요한 붉은 눈/n실외에서 모든 적군의 저항력 <val0>% 감소
Test_HalfSpirit	Test HalfSpirit	테스트용 반혼
desc_TestHalf_Spirit	Test HalfSpirit	테스트 반혼
TestItem	Test Items	테스트용 아이템
desc_TestItem	Test Items	테스트 아이템
Test_Class	Test Class	테스트용 클래스
desc_Test_Class	Test Class	테스트 클래스
Kain	Kain	카인
desc_Kain	<s1>Child of Captain</s1><s2>Captain of the Eltcamp</s2>	<s1>용병단장의 아이</s1><s2>엘트캠프의 용병단장</s2>
Kana	Kana	카나
desc_Kana	<s1>Child of Captain</s1><s2>Captain of the Eltcamp</s2>	<s1>용병단장의 아이</s1><s2>엘트캠프의 용병단장</s2>
Elrtra	Eltra	엘르트라
desc_Elrtra	The First God's Devine Maiden	초대 신의 신녀
Herwin	Herwin	헤르윈
desc_Herwin	King of the ruined	망국의 왕
Nia	Nia	니아
desc_Nia	Nonamed Hero	무명의 용사
Hyanne	Hyanne	히얀느
desc_Hyanne	<s1>Fallen Child of God</s1><s2>Child of River</s2>	<s1>추락한 신의 아이</s1><s2>강의 아이</s2>
Anna	Anna	안나
desc_Anna	The Deputy Captain of the Eltcamp	엘트캠프의 부단장
Nell	Nell	넬
desc_Nell	The Swordsman of the Eltcamp	엘트캠프의 검사
Diane	Diane	디아네
desc_Diane	The Ryeonier of the Eltcamp	엘트캠프의 연술사
Megian	Megian	메지안
desc_Megian	The Heal Ryeonier of the Eltcamp	엘트캠프의 회복술사
Suiru	Suiru	수이르
desc_Suiru	The Assassin of the Eltcamp	엘트캠프의 암살자
Kuusya	Kuusya	쿠샤
desc_Kuusya	The Ryeonier of the Eltcamp	엘트캠프의 연술사
Nov	Nov	노브
desc_Nov	Herwin's loyal soldier	헤르윈의 충직한 병사
Kemian	Kemian	케미안
desc_Kemian	The Soldier of the Jemarr	제마르의 병사
Bambine	Bambine	밤비네
desc_Bambine	The Deserter of The Jemarr	제마르의 탈주병
Imelda	Imelda	이멜다
desc_Imelda	The Orbering Ryeonier of the Delton	델톤의 떠돌이 연술사
Hana	Hana	하나
desc_Hana	'The Hunter of the Delton	델톤의 사냥꾼
Belvet	Belvet	벨벳
desc_Belvet	The Hunter of the Silence World	고요한 땅의 사냥꾼
Raure	Raure	라우레
desc_Raure	The Swordsman of the Silence World	고요한 땅의 검사
Teton	Teton	테톤
desc_Teton	The Swordsman of the Silence World	고요한 땅의 검사
Cyan	Cyan	시안
desc_Cyan	The Swordsman of the Silence World	고요한 땅의 검사
Denian	Denian	데니안
desc_Denian	The Monster Vigilance of the Silence World	고요한 땅의 마물경계병
Keneron	Keneron	케네론
desc_Keneron	The Prophet of the Silence World	고요한 땅의 예언자
Divelin	Divenlin	디벨린
desc_Divelin	An Exiled	추방당한 자
Kaol	Kaol	카올
desc_Kaol	Captain of the Eltcamp	엘트캠프의 용병단장
BattleConstitution	Battle Constitution	전투체질
desc_BattleConstitution	Recovers 'HP' <val0>% through kill enemy unit.\nWhen a turn starts, this unit acts first regardless of speed.	적 유닛 처치시 HP을 <val0>% 회복한다.\n속도와 상관없이 턴 시작시 가장 처음 행동한다.
Swift	Swift	가벼운 몸짓
desc_Swift	Increases 'Speed' by <val0>%.\nWhen a turn starts, this unit acts first regardless of speed.	속도가 <val0>% 증가한다.\n속도와 상관없이 턴 시작시 가장 처음 행동한다.
Beauty	Beauty	아름다움
desc_Beauty	Decreases 'Unit Bonus Damage' received by <val0>%.	받는 특효 피해량이 <val0>% 감소한다.
HerculeanStrength	Herculean Strength	태산같은 힘
desc_HerculeanStrength	Increases 'ATK' by <val0> for each first attack.	매 첫번째 공격에 한해 공격력이 <val0> 증가한다.
Salvation	Salvation	구원
desc_Salvation	If an ally within <val0> tiles, with less than <val1>% 'HP', is attacked, immediately invoke a turn.	인근 <val0>타일 이내에 HP이 <val1>%미만인 아군이 공격받을 경우 즉시 턴을 불러온다.
ChildOfRiver	Child of River	강의 아이
desc_ChildOfRiver	With each attack, a cumulative 'Water Element' of <val0> is accumulated, and the 'Unit Unit Bonus Damage' against 'Wet' units is occured.	모든 공격에 물 속성 누적치 <val0> 이 축적되며 젖음 상태의 유닛을 대상으로 특효가 발생한다.
ExpierencedVeteran	Expierenced Veteran	노련한 베테랑
desc_ExpierencedVeteran	When using the 'Evasion' card, the effect increases by <val0>.	회피카드 사용시 효과가 <val0> 증가한다.
Recovery	Recovery	재생
desc_Recovery	When starting the each battle, the unit recovers <val0>% of its 'HP'.	매 전투 시작시 HP을 <val0>% 회복한다.
RyeonialRampage	Ryeonial Rampage	연폭주
desc_RyeonialRampage	When using the Ryeon skill, <val1> stacking 'Ryeonial Rampage' effect increases the 'RYN' by <val0>% and can stack once. On the <val2>th 'Ryeonial Rampage', the 'RYN' increases by <val3>%, and the unit is 'Silenced' after the action for one turn.	연술 사용 시 연 수치가 <val0>% 증가하는 연 폭주가 <val1>회 중첩된다. <val2>번째 연 폭주 시 연 수치가 <val3>% 증가하며, 행동 이후 1턴간 침묵에 걸린다.
Embrace	Embrace	포용
desc_Embrace	The 'Recover Power' increases by <val0>%.	회복력이 <val0>% 증가한다.
ShadowWalk	Shadow Walk	그림자걸음
desc_ShadowWalk	The unit can pass through enemy units.	적 유닛을 통과할 수 있다.
TranditionalSorcery	Tranditional Sorcery	전통 주술
desc_TranditionalSorcery	Acquires the 'Kugunda's Flame' ability against targets with higher 'RES' than 'DEF'.	방어력보다 저항력이 높은 대상에 한해 '쿠군다의 화염' 연술을 획득한다.
Belief	Belief	신념
desc_Belief	Once per battlefield, withstands fatal damage with <val0> 'HP'.	매 전장마다 1회에 한해 치명적인 피해를 받을 시 <val1>의 HP으로 버틴다.
Strict	Strict	엄격
desc_Strict	Increases the damage of attack by <val1>% against enemy units with less than <val0>% 'HP'.	HP이 <val0>% 미만인 적 유닛을 대상으로 공격의 위력이 <val1>%증가한다.
Genius	Genius	천재
desc_Genius	Increases 'Experience' gain by <val0>%.	경험치 획득량이 <val0>% 증가한다.
Curiosity	Curiosity	호기심
desc_Curiosity	Increases 'RYN' by <val0>% against enemy units with full health.	HP이 가득 찬 적 유닛을 상대로 연이 <val0>% 증가한다.
EyesOfHunter	Eyes of Hunter	사냥꾼의 눈
desc_EyesOfHunter	Increases 'Accuracy' by <val0>.	명중이 <val0>증가한다.
FlameOfSilence	Flame of Silence	고요의 불씨
desc_FlameOfSilence	Inflicts 'Fire Element' by <val1> on enemy units within <val0> tiles each turn, and the 'Burn' on enemy units within that range does not expire until the end of the turn.	인근 <val0>타일의 적 유닛에게 매 턴마다 화염 속성을 <val1> 부여하며, 해당 범위 내의 적 유닛의 화상이 턴 종료로 풀리지 않는다.
HouseOfRyeonier	House of Ryeonier	연술사 가문
desc_HouseOfRyeonier	When receiving damage from Ryeon attack, increases 'ATK' by <val1>% for <val0> turn.	연술 피해를 받을 경우 <val0>턴간 공격력이 <val0>% 증가한다.
HouseOfSwordman	House of Swordman	검사 가문
desc_HouseOfSwordman	Increases 'Evasion and Accuracy' by <val0> against units equipped with swords.	검을 장비한 유닛을 상대로 회피, 명중이 <val0> 증가한다.
FreeStride	Free Stride	자유로운 발걸음
desc_FreeStride	If there are no allied units within <val0> tiles, increases movement range by <val1>.	인근 <val0>타일 내에 아군이 없을 경우 이동력이 <val1>증가한다.
Vigilance	Vigilance	경계태세
desc_Vigilance	Increases 'Accuracy' by <val0> for counterattacks.	반격에 한해 명중이 <val0> 증가한다.
Foresight	Foresight	미래예지
desc_Foresight	Increases 'Evasion' by <val0> and consumes <val1> 'HP' every turn.	회피가 <val0> 증가하며 매 턴마다 HP이 <val1> 소모된다.
ChildOfRyeon	Child of Ryeon	연의 아이
desc_ChildOfRyeon	Increases the range of Ryeon skill by <val0>.	연술의 사거리가 <val0>증가한다.
Leadership	Leadership	지휘력
desc_Leadership	Increases 'DEF' and 'ATK' by <val1>% for each allied unit within <val0> tiles.	인근 <val0>타일 내에 아군의 수만큼 방어력, 공격력이 <val1>% 증가한다.
HP	HP	HP
desc_HP	Unit's health points, 'HP', become zero, the unit is knocked out.	유닛의 생명력, HP가 0이 될시 쓰러진다.
SP	SP	기력
desc_SP	Consumed in actions such as attacks.	공격 등의 일부 행동에 소모된다.
Str	STR	근력
desc_Str	Affects the 'SPD' variation caused by the 'Weight' of the equipment.	장비 무게로 인한 속도변화에 영향을 준다.
Atk	ATK	공격력
desc_Atk	Inflicts physical damage to enemies.	적에게 물리피해를 입힌다.
Ryn	RYN	연
desc_Ryn	Inflicts Ryeon damage to enemies.	적에게 연 피해를 입힌다.
Spd	SPD	속도
desc_Spd	Affects 'Evasion', and turn priority./nDuring a basic attack, for every difference of <val0>, <val1>, <val2>, <val3> or <val4> in 'SPD', an additional attack occurs once.	회피, 턴 우선순위에 영향을 준다./n기본공격시 속도가 <val0>, <val1>, <val2>, <val3>, <val4>의 차이가 날 때마다 1회의 추가 공격이 발생한다.
Dex	DEX	재주
desc_Dex	Affects 'Evasion', 'Accuracy'.	명중, 회피에 영향을 준다.
Def	DEF	방어력
desc_Def	Reduces physical damage.	물리 피해를 경감한다.
Res	RES	저항
desc_Res	Reduces Ryeon damage.	연 피해를 경감한다.
Swordsman	Swordsman	검사
desc_Swordsman	A combatant who wields a sword.	검으로 전투를 치루는 자.
SwordMaster	Sword Master	소드마스터
desc_SwordMaster	A person who handles a sword very skillfully	검을 매우 능숙히 다루는 자.
SwordDeity	Sword Deity	검신
desc_SwordDeity	One who is always accompanied by a sword.	매 순간을 검과 함께한 자.
Fighter	Fighter	투사
desc_Fighter	One who purely enjoys battles.	순수히 전투 자체를 즐기는 자.
Asura	Asura	아수라
desc_Asura	Life's purpose is battle itself.	삶의 목적은 전투 그 자체.
Soldier	Soldier	병사
desc_Soldier	Military personnel gathered for various reasons.	저마다의 이유로 모인 군사.
EliteSoldier	Elite Soldier	정예병
desc_EliteSoldier	A soldier with significant experience.	많은 경험을 가진 군사.
General	General	장수
desc_General	A highly skilled and experienced soldier.	뛰어난 기량을 인정받은 군사.
Hunter	Hunter	사냥꾼
desc_Hunter	One who hunts enemies using arrows and traps.	화살과 함정 등으로 적을 사냥하는 자.
Assassin	Assassin	암살자
desc_Assassin	Moves stealthily and subdues enemies in an instant.	은밀하게 움직이며 순식간에 적을 제압하는 자.
Paladin	Paladin	팔라딘
desc_Paladin	Supports allies with the Ryeon and fights at the forefront.	연의 힘으로 아군을 지원하며 최전방에서 싸우는 자.
Ryeonier	Ryeonier	연술사
desc_Ryeonier	One who wields the Ryeon.	연의 힘을 다루는 자.
HealRyeonier	Heal Ryeonier	회복술사
desc_HealRyeonier	Harnesses the Ryeon for healing.	연을 이용해 회복의 힘을 다루는 자.
WhiteRyeonier	White Ryeonier	백연술사
desc_WhiteRyeonier	Master of white Ryeon.	백색 연을 다루는 자.
BlackRyeonier	Black Ryeonier	흑연술사
desc_BlackRyeonier	Master of black Ryeon.	흑색 연을 다루는 자.
SoulRyeonier	Soul Ryeonier	영혼술사
desc_SoulRyeonier	Manipulates souls using the Ryeon.	연의 힘으로 영혼을 다루는 자.
LivingSoulRyeonier	Living Soul Ryeonier	생령술사
desc_LivingSoulRyeonier	Manipulates the souls of living beings using the Ryeon.	연의 힘으로 살아있는 자의 영혼을 다루는 자.
NecroRyeonier	Necro Ryeonier	사령술사
desc_NecroRyeonier	Manipulates the souls of the deceased using the Ryeon.	연의 힘으로 죽은 이의 영혼을 다루는 자.
NaturalRyeonier	Natural Ryeonier	자연술사
desc_NaturalRyeonier	Harnesses the Ryeon to manipulate the forces of nature.	연을 이용해 자연의 힘을 다루는 자.
FlameRyeonier	Flame Ryeonier	화염술사
desc_FlameRyeonier	Manipulates the flames using Ryeon.	화염의 연술을 다루는 자.
FrostRyeonier	Frost Ryeonier	냉기술사
desc_FrostRyeonier	Manipulates the frost using Ryeon.	냉기의 연술을 다루는 자.
LightningRyeonier	Lightning Ryeonier	뇌전술사
desc_LightningRyeonier	Manipulates lightning using Ryeon.	뇌전의 연술을 다루는 자.
StormRyeonier	Storm Ryeonier	폭풍술사
desc_StormRyeonier	Manipulates storms using Ryeon.	폭풍의 연술을 다루는 자.
EarthRyeonier	Earth Ryeonier	대지술사
desc_EarthRyeonier	Manipulates the earth using Ryeon.	대지의 연술을 다루는 자.
CaptainOfTheMercenaries	Captain of the Mercenaries	용병단장
desc_CaptainOfTheMercenaries	Commander of a mercenaries.	용병단의 지휘자.
DivineMadien	Devine Maiden	신녀
desc_DivineMadien	One who receives the blessing of the god and follows its will.	신의 축복을 받아 의지를 따르는 자.
TheKing	The King	더 킹
desc_TheKing	The ruler of a nation.	일국의 왕.
Hero	Hero	용사
desc_Hero	The savior of humanity.	인류의 구원자.
LostWings	Lost Wings	날개 없는 자
desc_LostWings	One who has fallen to the Cyclic World after losing their wings.	날개를 잃고 순환의 땅으로 추락한 자.
TheDivine	The Divine	신족
desc_TheDivine	The Owner of the Silence World who possess wings.	날개를 지닌 고요한 땅의 주인.
PowerSmash	Power Smash	강력한 일격
desc_PowerSmash	Unleashes a devastating strike./nThis attack increases the 'Accuracy' by <val0>.	강력한 일격을 가한다./n해당 공격은 명중이 <val0> 증가한다.
SlashHalfSpirit	Slash Half Soul	반혼베기
desc_SlashHalfSpirit	Cuts through the target's Half Spirit, nullifying its effects for one turn. 'Unit Bonus Damage' occurs when targeting a 'Half Spirit'	대상의 반혼을 베어내어 한 턴간 대상의 반혼 효과를 무효화한다. 반혼을 대상으로 특효가 발생한다.
HorizontalSlash	Horizontal Slash	횡베기
desc_HorizontalSlash	Attacks enemies in a <val0>-tile range in front.	전방의 <val1>타일의 적을 공격한다.
Thrash	Thrash	난격
desc_Thrash	Attacks random enemies within <val1> tile, <val0> times.	인근 <val1>타일 내의 적을 무작위로 <val0>회 공격한다.
BattleCommand	Battle Command	진두지휘
desc_BattleCommand	Attacks nearby allies within <val0> tiles, the number of allies being n.	인근 <val0>타일 내의 아군 n명만큼 공격한다.
ExplosiveRyeon	Explosive Ryeon	연폭발
desc_ExplosiveRyeon	Attacks the target, increasing own 'RYN' by <val0> for the turn.	대상을 공격한다, 해당 턴 동안 연이 <val0>증가한다.
Encouragement	Encouragement	격려
desc_Encouragement	Increases 'ATK' by <val1> for <val0> turns.	아군을 격려하여 <val0>회의 공격동안 공격력을 <val1>증가한다.
FuneralRites	Funeral Rites	장례
desc_FuneralRites	Increases own 'RYN' by <val1> and 'SPD' by <val2> for <val0> turns.	획득한 영혼의 장례를 치러 <val0>턴간 연 <val1>, 속도 <val2>이 증가한다.
SoulAbsorption	Soul Absorption	흡령
desc_SoulAbsorption	Decreases the enemy's 'ATK', 'RYN', and 'SPD' by <val1> for <val0> turns.	획득한 영혼을 흡수하여 <val0>턴간 상대의 공격력 연 속도를 <val1> 감소시킨다.
SpiritPossession	Spirit Possession	강령
desc_SpiritPossession	Summons acquired souls, causing additional soul attacks for all own attacks for <val0> turns. *Follows the attack type of the equipped weapon.	획득한 영혼을 강림시켜 <val0>턴간 내 모든 공격에 영혼이 추가 공격을 가한다. *장착한 무기의 공격 유형을 따름
InfernoFlame	Inferno Flame	지옥불꽃
desc_InfernoFlame	Ignites all adjacent <val0> tiles, accumulating 'Fire Element' of <val1>.	자신의 인근 <val0>타일을 모두 불태워 <val1>의 화염 속성을 누적시킨다.
GaleStorm	Gale Storm	대폭풍
desc_GaleStorm	Targets the enemy, unleashing a massive storm that pushes up to <val0> tiles.	대상을 향해 거대한 폭풍을 불러일으켜 최대 <val0>타일 밀어낸다.
DivinePunishment	Divine Punishment	천벌
desc_DivinePunishment	Delivers a powerful strike to the target. If the target is defeated by this skill, all targets within <val0> tile of the target are inflicted with Fear for <val1> turns.	대상에게 강력한 일격을 가한다. 해당 기술로 처치시 인근 <val0>타일 내의 적 유닛에게 <val1>턴간 대상에게 공포 부여
FlameArrow	Flame Arrow	불화살
desc_FlameArrow	Attacks the target, inflicting 'Fire Element' of <val0>.	대상을 공격하며 불속성 <val1>부여한다.
ArrowRain	Arrow Rain	화살비
desc_ArrowRain	Attacks all targets within <val0> tile of the target.	대상 인근 <val0>타일의 모든 대상 공격한다.
Photosynthesis	Photosynthesis	광합성
desc_Photosynthesis	Recovers own health.	자신의 HP 회복한다.
CrystalArrow	Crystal Arrow	결정화살
desc_CrystalArrow	Attacks the target, increasing the skill's 'Accuracy' by <val0>.	대상을 공격한다. 해당 연술의 명중이 <val0>증가한다.
Wind	Wind	윈드
desc_Wind	Attacks the target, inflicting 'Wind Element' of <val0>.	대상을 공격하며 바람속성 <val0>부여한다.
ChainLightning	Chain Lightning	체인 라이트닝
desc_ChainLightning	Attacks all contacted enemies, inflicting 'Lightning Element' of <val0>.	접촉한 모든 적을 공격하며 번개속성 <val0>부여한다.
StellarFall	Stellar Fall	별빛낙하
desc_StellarFall	Drops stars on the target's location, with a <val0>% chance of 'Confusion' for <val1> turn.	대상의 위치에 별빛을 떨어뜨린다, <val0>%확률로 <val1>턴간 혼란 부여한다.
PiercingThrust	Piercing Thrust	꿰뚫기
desc_PiercingThrust	Attacks enemy units within a straight line of <val0> tiles.	직선상 <val0>타일의 범위의 적군을 공격한다.
PowerfulStrike	Powerful Strike	대강타
desc_PowerfulStrike	Attacks the target.	대상을 공격한다.
SpiritualEyes	Spiritual Eyes	심안
desc_SpiritualEyes	Increases the first 'Accuracy' by <val0>% every turn.	매 턴마다 첫 명중이 <val0>% 증가한다.
StrongBacking	Strong Backing	강한기백
desc_StrongBacking	Reduce damage from the enemy's first attack by <val0>%.	적의 첫 공격 피해량이 <val0>% 감소한다.
FlowReading	Flow Reading	흐름읽기
desc_FlowReading	Increase accumulated 'Element' values for all 'Element' by <val0>.	모든 속성누적치가 <val0>증가한다.
Insight	Insight	통찰
desc_Insight	Increase 'Evasion' by <val0>.	회피가 <val0> 증가한다.
Breath	Breath	호흡
desc_Breath	Increase 'Accuracy' by <val0>.	명중이 <val0> 증가한다.
PassingBy	Passing By	스쳐지나가기
desc_PassingBy	Can pass through enemy units while moving.	적 유닛을 지나 이동할 수 있다.
DefensiveStance	Defensive Stance	수비자세
desc_DefensiveStance	Increase 'DEF' or 'RES' by <val0> depending on the enemy's attack type.	상대 공격 유형에 따라 방어력 혹은 저항력이 <val0>증가한다.
Purity	Purity	순백
desc_Purity	When healing allies with own Ryeon skill, increase the 'ATK' of the healed ally by <val0>%.	자신의 연술로 아군 회복시 해당 아군의 공격력이 <val0>%증가한다.
Stigma	Stigma	성흔
desc_Stigma	Reduce 'DEF' and 'RES' of the enemy for <val0> turns when attacked.	적 공격시 <val0>턴간 방어력, 저항력이 <val1>% 감소한다.
FlowOfRyeon	Flow of Ryeon	연의 흐름
desc_FlowofRyeon	Grant additional 'Element' to attacks based on own terrain.	자신의 지형에 따라 공격에 추가 속성 <val0>을 부여한다.
Freezing	Freezing	빙결화
desc_Freezing	Increase 'DEF' and 'RES' by <val0>%.	방어력 저항력이 <val0>% 증가한다.
PowerCharge	Power Charge	전력충전
desc_PowerCharge	Increase 'SPD' by <val0>% when 'Electrified'.	감전 시 속도가 <val0>% 증가한다.
Rock'sProtection	Rock's Protection	바위의 보호
desc_Rock'sProtection	Increase 'DEF' by <val0>%, immune to 'Bleed'.	방어력이 <val0>% 증가하며, 출혈에 면역이된다.
Rescue	Rescue	구원
desc_Rescue	Restore the 'HP' of the ally with the lowest 'HP' ratio by the amount of damage dealt when attacking.	공격 시 첫 공격의 피해량만큼 HP비율이 가장 낮은 아군의 HP를 회복한다.
Devine	Devine	신성
desc_Devine	Immune to all 'CC'.	모든 상태이상에 면역이된다.
HeavySword	Heavy Sword	중검
desc_HeavySword	Decrease 'Attack Speed' and increase 'ATK' in own battles.	내가 거는 전투에서 공격속도가 <val0> 감소, 공격력이 <val1> 증가한다.
SwiftSword	Swift Sword	쾌검
desc_SwiftSword	Increase 'Attack Speed' and decrease 'ATK' in own battles.	내가 거는 전투에서 공격속도가 <val0> 증가, 공격력이 <val1> 감소한다.
IronBody	Iron Body	철인
desc_IronBody	Increase 'HP' by <val0> and 'DEF' by <val1>.	HP가 <val0> 증가하며 방어력이 <val1> 증가한다.
SteelHealth	Steel Health	강철체력
desc_SteelHealth	Increase 'HP' by <val0> and <val1>%.	HP가 <val0> 증가하며 <val1>% 증가한다.
StrongBones	Strong Bones	강골
desc_StrongBones	Increase 'ATK' by <val0> and 'HP' by <val1>.	공격력이 <val0>증가하며 체력이 <val1>증가한다.
Expert	Expert	달인
desc_Expert	Increase 'ATK' by <val0> and <val1>%.	공격력이 <val0> 증가하며 <val1>% 증가한다.
Blessing	Blessing	축복
desc_Blessing	Increase 'RYN' by <val0> and <val1>%.	연이 <val0> 증가하며 <val1>% 증가한다.
Grace	Grace	은혜
desc_Grace	Increase Healing by <val0>%.	회복량이 <val0>% 증가한다.
SturdyBody	Sturdy Body	단단한 몸
desc_SturdyBody	Increase 'DEF' by <val0>.	방어력이 <val0> 증가한다.
Seasoned	Seasoned	단련가
desc_Seasoned	Increase 'DEF' by <val0>.	방어력이 <val0> 증가한다.
Inborn	Inborn	천성
desc_Inborn	Increase 'RES' by <val0>.	저항력이 <val0> 증가한다.
Stream	Stream	흐름
desc_Stream	Increase 'RES' by <val0>.	저항력이 <val0> 증가한다.
Agile	Agile	날렵
desc_Agile	Increase 'SPD' by <val0> and 'Evasion' by <val1>.	속도가 <val0>증가하며 회피가 <val1> 증가한다.
Decent	Decent	준족
desc_Decent	Increase 'SPD' by <val0>.	속도가 <val0> 증가한다.
MoneyMaker	Money Maker	돈벌레
desc_MoneyMaker	Increase acquired gold when defeating enemies by <val0>%.	적 처치시 획득 골드가 <val0>% 증가한다.
ToughSkin	Tough Skin	질긴피부
desc_ToughSkin	Increase 'Fire Resistance' by <val0>%.	화염 내성이 <val0>% 증가한다.
WarmBlood	Warm Blood	따뜻한 피
desc_WarmBlood	Increase 'Frost Resistance' by <val0>%, reduce 'Wet' duration by <val1>%.	냉기 내성이 <val0>% 증가하며 젖음 상태이상의 턴이 <val1>% 감소한다.
SpecialConstitution	Special Constitution	특이체질
desc_SpecialConstitution	Increase 'Lightning Resistance' by <val0>%, recover 'HP' by <val1>% when stunned.	번개 내성이 <val0>% 증가하며 기절 시 HP를 <val1>% 회복한다.
SharpAttack	Sharp Attack	날카로운 공격
desc_SharpAttack	Increase 'Defense Penetration' by <val0>.	방어관통력이 <val0> 증가한다.
CursedAttack	Cursed Attack	저주받은 공격
desc_CursedAttack	Increase 'Resistance Penetration' by <val0>.	저항관통력이 <val0> 증가한다.
Fire Element	Fire Element	화염 속성
desc_Fire Element	Inflict 'Burn' when accumulated./nCannot apply 'Fire Element' to targets with 'Wet'./nIf a target in 'Burn' gets affected by 'Wet', the damage from 'Burn' becomes <val0>./n	누적 시 화상 상태이상을 부여한다./n젖음 상태인 대상에게는 화염 속성을 부여할 수 없다./n화상인 상태에서 젖음 상태이상에 걸릴 경우 화상의 피해량이 <val0>이된다.
Water Element	Water Element	물 속성
desc_Water Element	Inflict 'Wet' when accumulated.	누적 시 젖음 상태이상을 부여한다.
Frost Element	Frost Element	냉기 속성
desc_Frost Element	Inflict 'Frozen' when accumulated.	누적 시 빙결 상태이상을 부여한다.
Lightning Element	Lightning Element	번개 속성
desc_Lightning Element	Inflict 'Electrify' when accumulated./nDeal <val0>% additional damage to targets with 'Wet'.	누적 시 감전 상태이상을 부여한다./n젖음 상태인 대상에게 <val0>%의 추가 피해를 입힌다.
Wind Element	Wind Element	바람 속성
desc_Wind Element	Inflict 'Confusion' when accumulated.	누적 시 혼란 상태이상을 부여한다./n젖음 상태이상을 제거한다.
Earth Element	Earth Element	대지 속성
desc_Earth Element	Inflict 'Stun' when accumulated.	누적 시 기절 상태이상을 부여한다.
Poison	Poison	독
desc_Poison	Deal <val0>% damage each turn.	턴마다 <val0>%의 피해를 입힌다.
Weakness	Weakness	쇠약
desc_Weakness	Decrease 'ATK' by <val0>%.	공격력이 <val0>% 감소한다.
Vulnerable	Vulnerable	취약
desc_Vulnerable	Decrease 'DEF' by <val0>%.	방어력이 <val0>% 감소한다.
Burn	Burn	화상
desc_Burn	Deal <val0>% damage in each battle.	전투마다 <val0>%의 피해를 입힌다.
Bleed	Bleed	출혈
desc_Bleed	Deal <val0>% damage when moving.	이동 할 때 마다 <val0>%의 피해를 입힌다.
Wet	Wet	젖음
desc_Wet	If a target in 'Stun' gets affected by 'Wet', 'Stun' is removed./nImmune to 'Burn'./nIf a target in 'Burn' gets affected by 'Wet', the damage from 'Burn' becomes <val0>./nIf a target in 'Wet' gets affected by 'Frozen', it takes <val1>% 'HP' damage./nIf a target in 'Frozen' gets affected by 'Wet', the duration of 'Frozen' increases instead of applying 'Wet'./nIncrease damage of 'Lightning Element' by <val2>%.	기절인 상태에서 젖음 상태이상에 걸릴 경우 기절이 해제된다./n화상에 면역이된다. 화상인 상태에서 젖음 상태이상에 걸릴 경우 화상 피해가 <val0>이 된다./n젖음 상태에서 빙결 상태이상에 걸릴 경우 HP의 <val1>%의 피해를 입는다./n빙결인 상태에서 젖음 상태이상에 걸릴 경우 젖음 상태이상 대신 빙결의 턴이 증가한다./n번개 속성의 피해량이 <val2>% 증가한다.
Frozen	Frozen	빙결
desc_Frozen	Decrease Speed by <val0>%./nImmune to 'Bleed'./nIf a target in 'Bleed' gets affected by 'Frozen', 'Bleed' is removed.	속도가 <val0>% 감소한다./n출혈에 면역이 된다./n출혈 상태에서 빙결 상태이상에 걸릴 경우 출혈이 제거된다.
Electrified	Electrified	감전
desc_Electrified	Decrease 'Accuracy' by <val0>%./nImmune to 'Stun'./nIf a target in 'Stun' gets affected by 'Electrify', 'Stun' is removed.	명중이 <val0>% 감소한다./n기절에 면역이된다./n기절인 상태에서 상태에서 감전 상태이상에 걸릴 경우 기절이 해제된다.
Confusion	Confusion	혼란
desc_Confusion	Decrease 'Ryeon' by <val0>%, decrease 'RES' by <val1>%.	연이 <val0>%, 저항력이 <val1>% 감소한다.
Stun	Stun	기절
desc_Stun	Cannot take any actions.	아무런 행동을 취할 수 없다.
Blind	Blind	실명
desc_Blind	Cannot perform physical attacks.	물리 공격을 할 수 없다.
Silence	Silence	침묵
desc_Silence	Cannot use Ryeon skills.	연술을 사용할 수 없다.
Bindness	Binding	속박
desc_Bindness	Cannot move.	이동을 할 수 없다.
Fear	Fear	공포
desc_Fear	Set movement to 1 and flee from the target, excluding 'Binding'.	(속박을 제외한 상태에서)이동력을 1로 변경시키고 대상으로부터 도망간다.
HoundSpirit	Hound Spirit	개의 반혼
desc_HoundSpirit	Movement' is increased by <val0>.	이동력이 <val0>증가한다.
WolfSpirit	Wolf Spirit	늑대의 반혼
desc_WolfSpirit	'Armor Penetration' is increased by <val0>%.	방어관통력이 <val0>% 증가한다.
BearSpirit	Bear Spirit	곰의 반혼
desc_BearSpirit	ATK' is increased by <val0>.	공격력이 <val0> 증가한다.
LionSpirit	Lion Spirit	사자의 반혼
desc_LionSpirit	ATK' is increased by <val0>, 'Attack Speed' is increased by <val1>.	공격력이 <val0>, 속도가 <val1> 증가한다.
ElephantSpirit	Elephant Spirit	코끼리의 반혼
desc_ElephantSpirit	HP' is increased by <val0>, 'DEF' is increased by <val1>.	체력이 <val0>, 방어력이 <val1> 증가한다.
GroundDragonSpirit	Ground Dragon Spirit	지룡의 반혼
desc_GroundDragonSpirit	Damage of the first attack I make in battle is increased by <val0>%.	내가 거는 전투 시 첫 번째 공격의 피해량이 <val0>% 증가한다.
EarthDragonSpirit	Earth Dragon Spirit	토룡의 반혼
desc_EarthDragonSpirit	When engaged in battle by the opponent, 'DEF' is increased by <val0>%.	상대가 거는 전투 시 방어력이 <val0>% 증가한다.
BlundasSpirit	Blundas Spirit	블룬다스의 반혼
desc_BlundasSpirit	'Fire Resistance' increases by <val0>%, 'Fire Element' accumulation increases by <val1>%.	화염 내성이 <val0>%, 화염 속성 누적이 <val1>% 증가한다.
TwilightGroundBugSpirit	Twilight Ground Bug Spirit	황혼 땅벌레의 반혼
desc_TwilightGroundBugSpirit	At the beginning of every battle, there is a <val0>% chance to inflict 'Silence' on the enemy.	모든 전투에서 첫 공격 시 <val0>% 확률로 <val1>턴간 침묵을 부여한다.
BlindAssassinSpirit	Blind Assassin Spirit	눈 먼 암살자의 반혼
desc_BlindAssassinSpirit	Evasion' increases by <val0>% for opponents affected by 'CC'.	상태이상에 걸린 상대에 한해 회피가 <val0> 증가한다.
ButterflySpirit	Butterfly Spirit	나비의 반혼
desc_ButterflySpirit	Evasion' increases by <val0>%.	회피가 <val0> 증가한다.
BeeSpirit	Bee Spirit	벌의 반혼
desc_BeeSpirit	Ryn' increases by <val0>.	연이 <val0> 증가한다.
HawkSpirit	Hawk Spirit	매의 반혼
desc_HawkSpirit	Spd' increases by <val0>.	속도가 <val0> 증가한다.
OwlSpirit	Owl Spirit	올빼미의 반혼
desc_OwlSpirit	If there are <val0> or more allied units within the attack range, this unit will not be targeted.	대상의 공격 범위내 아군이 <val0>명 이상일 경우 공격대상으로 지정받지 않는다.
GriffinSpirit	Griffin Spirit	그리핀의 반혼
desc_GriffinSpirit	Damage increases by <val0>% proportionally to the movement distance in the current turn.	해당 턴의 이동거리에 비례하여 피해량이 <val0>% 증가한다.
FlyingDragonSpirit	Flying Dragon Spirit	비룡의 반혼
desc_FlyingDragonSpirit	When counterattacking, 'Unit Unit Bonus Damage' is increased by <val0>%.	반격의 특효 피해량이 <val0>% 증가한다.
ChaoticDragonSpirit	Chaotic Dragon Spirit	마룡의 반혼
desc_ChaoticDragonSpirit	When engaged in battle by the opponent, 'RES' is increased by <val0>%.	상대가 거는 전투 시 저항력이 <val0>% 증가한다.
CrimakksSpirit	Crimakks Spirit	크리마크스의 반혼
desc_CrimakksSpirit	Lightning Resistance' increases by <val0>%, 'Lightning Element' accumulation increases by <val1>%.	전기 내성이 <val0>%, 전기 속성 누적이 <val1>% 증가한다.
DawnFlyingSpiderSpirit	Duskmantle Spider Spirit	어스름 날거미의 반혼
desc_DawnFlyingSpiderSpirit	Ryn' increases when evading an attack by <val0>%.	공격 회피시 연이 <val0> 증가한다.
SleepingAngelSpirit	Sleeping Angel Spirit	잠든 천사의 반혼
desc_SleepingAngelSpirit	Upon reaching 20% or less health in each battlefield, gain invincibility once.	매 전장마다 체력이 <val0>% 이하일 경우 <val1>회 피해면역을 얻는다.
SoulCrusher	Soul Crusher	영혼분쇄기
desc_SoulCrusher	Dull blades are lethal to souls./nRemove the souls of nearby Soul, Living Soul, and Necro Ryeonier within <val0> tiles.	뭉툭한 날은 영혼들에게 치명적이다./n인근 <val0>타일 내의 영혼술사, 생령술사, 사령술사의 영혼을 제거한다.
Umbrella	Umbrella	우산
desc_Umbrella	Be cautious as it may rain./n'Water Element' <val0>, 'Lightning Element' <val1>.	비가 올 수 있으니 주의하세요./n물 속성 <val0>, 전기 속성 <val1>
RedUmbrella	Red Umbrella	붉은 우산
desc_RedUmbrella	Be cautious as it may rain./n'Water Element' <val0>, 'Lightning Element' <val1>. If it's raining, reduce damage received by <val2>%.	비가 거셀 수 있으니 주의하세요./n물 속성 <val0>, 전기 속성 <val1>, 비가 내리는 경우 상대의 피해량을 <val2>% 경감한다.
FoxSilverKnife	Fox Silver Knife	여우 은장도
desc_FoxSilverKnife	A nimble fox, a mask, and Silver knife./nIf the 'Attack Speed' is higher than the target's, increase the 'Attack speed' difference by <val0>%.	날렵한 여우와 가면 그리고 은장도/n대상보다 공격속도가 높을 경우 공격속도 차이가 <val0>% 증가한다.
Sodett	Sodett	소데트
desc_Sodett	1st StarEaten, Sodett/n'Fire Element' <val0>, Sodett inflict Unit Bonus Damage to every unit, but 'Unit Unit Bonus Damage' is changed to <val4>%\n Soddet,deals additional damage equal to accumulated 'Burn' damage. If this unit is '<val2>' and '<val5>' is in inventory, gain a skill '<val6>' and a shield equal to <val1>% of maximum 'HP' and 'Frost Element' immunity every turn, based on the number of units with accumulated 'Burn'. If equipped by a unit other than '<val2>', lose <val3>% of health every turn.	첫 번째 성식, 소데트/n화염 속성 <val0>, 누적된 화상피해 만큼 추가피해를 입힌다. 모든 유닛에 대해 특효가 발생하지만 특효의 피해가 <val4>%만 증가합니다. 해당 유닛이 <val2>이며, '<val5>'가 인벤토리에 있을 시 '<val6>'스킬을 획득하며, 매 턴마다 화염 속성이 누적된 유닛의 수 만큼 최대 체력의 <val1>% 만큼의 보호막과 냉기 면역을 획득한다. '<val2>' 이외의 유닛이 장비 시 매 턴마다 체력의 <val3>%의 피해를 입는다.
Dorrmu	Dorrmu	도르무
desc_Dorrmu	2nd Returning Star, Dorrmu/nIf an enemy is defeated within the same turn when Dorrmu is equipped by '<val0>', enter a 'Concentrated'. While in a 'Concentrated', increase 'Armor Penetration' by <val1>%, reduce damage taken by <val2>%, remove all 'CC', and gain immunity.	두 번재 회성, 도르무/n'<val0>'이(가) 장착 시 이번 턴 내에 적군이 처치되었을 경우 집중상태에 돌입한다. 집중상태에서는 방어관통력이 <val1>% 증가, 받는 피해량이 <val2>% 경감하며 모든 상태이상이 해제되고 면역을 얻는다.
HoroonBlade	Horoon Blade	호룬 블레이드
desc_HoroonBlade	4th Rest, Horoon Blade/nDuring equipment, 'RES' increases by <val0>% of 'DEF'. When attacking enemies with higher 'ATK' than 'RYN', it inflicts 'Silence'. Units other than <val1> suffer <val2>% of their 'HP' as damage with each attack.	네 번째 안식, 호룬 블레이드/n장비한 동안 저항력이 방어력의 <val0>%만큼 증가한다. 공격력보다 연이 높은 적 공격 시 침묵을 부여한다. '<val1>' 이외의 유닛이 장비시 매 공격마다 체력의 <val2>%의 피해를 입는다.
Andett	Andett	안데트
desc_Andett	6th Destiny, Andett/n'Frozen' <val0>. if this unit is '<val2>' and '<val5>' is in inventory, gain a skill "<val4>". If the target is gained already 'Burn', applies 'Frozen' equal to the remaining 'Burn'. Upon defeating enemies, this unit gains a shield equal to <val1>% of its 'HP'. While the shield is active, it becomes immune to 'Burn'. If equipped by units other than <val2>, the weapon's 'ATK' is reduced by <val3>%.	여섯 번째 숙명, 안데트/n냉기 속성 <val0>, 해당 유닛이 '<val2>이며 '<val5>'가 인벤토리에 있을 시 <val4> 스킬을 획득한다. 대상이 화상에 걸려있을 경우 남은 화상을 즉시 발현시키고 해당 턴만큼 빙결을 부여한다. 적을 처치할 때마다 체력의 <val1>% 만큼의 보호막을 획득한다. 보호막이 유지되는 동안 화상 면역을 얻는다. '<val2>'이외의 유닛이 장비시 해당 무기의 공격력이 <val3>%만 적용된다.
VoidAbsorber	Void Absorber	공허흡수기
desc_VoidAbsorber	Can absorb anything./nRecovers <val0>% of the damage dealt and absorbs the accumulated 'Element' of the target.	뭐든지 빨아들일 수 있습니다./n피해량의 <val0>% 만큼 회복한다. 대상의 누적된 속성치를 흡수한다.
TransdimensionalEmitter	Transdimensional Emitter	전이방출기
desc_TransdimensionalEmitter	Beware of sudden noise./nTransfers <val0>% of the accumulated 'Element' and 'CC' to the enemy.	갑작스러운 소음을 주의하세요./n가지고 있는 속성 누적치의 <val0>%와 상태이상을 적에게 전이시킨다.
UnstableDimensionalTeleporter	Unstable Dimensional Teleporter	불안정한 차원 이동기
desc_UnstableDimensionalTeleporter	"Where am I?"/nAfter attacking a target, teleport to a random tile within 3 tiles. It cannot move to the tile it moved from during the same turn.	"여기가 어디지?"/n대상을 공격한 후 인근 3타일 내의 무작위 타일로 이동한다. 같은 턴 동안 효과로 이동한 타일로는 이동할 수 없다.
FelvenBermel	Felven Bermel	펠븐 버멜
desc_FelvenBermel	3rd Desire, Felven Bermel/nWhenever allied units within <val0> tiles take any damage, this unit's 'ATK' increases by <val1> for <val2> turns. If equipped by units other than <val3>, 'HP' decreases by <val4>% with each battle.	세 번째 욕망, 펠븐 버멜/n인근 <val0>타일 내의 아군이 어떤 식으로든 피해를 입을 때마다 <val1>만큼 공격력이 증가한다. <val2>턴간 유지된다. <val3> 이외의 유닛이 장비시 매 전투마다 체력이 <val4>% 감소한다.
Burava	Burava	부라바
desc_Burava	8th Delight, Burava/n'Fear' <val0>. Inflicts 'Fear' for <val1> turns on the first enemy attacked by 'Burava'. Increases allied units' 'Armor Penetration' and 'Resistance Penetration' by <val2>% for each enemy affected by 'Fear'.	여덟 번째 환성, 부라바/n공포 <val0>, 부라바에 처음 공격당한 적에게 공포 상태이상을 <val1>턴간 부여한다. 공포에 걸린 적의 수 만큼 아군의 방어관통력과 저항관통력이 <val2>% 증가한다.
Sioon	Sioon	시운
desc_Sioon	12th Silence, Sioon/n'Silence' <val0>. Creates a pillar at the original position when moving, which lasts for <val1> turns. The pillar has <val2>% of the this unit's 'HP' and absorbs damage received by allied units within <val3> tiles. If the pillar is destroyed, it inflicts stun for <val4> turns on the enemy unit that last damaged the pillar.	열두 번째 침묵, 시운/n침묵 <val0>, 이동시 기존의 위치에 <val1>턴간 유지되는 기둥을 생성한다. 기둥은 소지자의 <val2>%의 체력을 가진다. 기둥은 인근 <val3>타일 내에서 아군 유닛이 받는 피해량을 흡수하며, 기둥이 파괴될 경우 마지막으로 기둥에 피해를 입힌 적군 유닛에게 <val4>턴간 기절을 부여한다.
TorrbonBreaker	Torrbon Breaker	토르본 브레이커
desc_TorrbonBreaker	5th Pray, Torrbon Breaker/n'Special Unit damage' applies only <val0>% of the damage. If the 'Total Weight' is higher than the target's 'Total Weight' value, it always hits.	다섯 번째 기도, 토르본 브레이커/n특효 피해량이 <val0>%만 적용된다. 총합 무게가 적보다 높을 경우 무조건 적중한다.
EterKrsour	Eter Krsour	이터 크루소
desc_EterKrsour	9th Hypocrisy, Eter Krsour/n'Earth Element' <val0>. Inflicts Ryeon damage. For each enemy not defeated, 'HP' decreases by <val1>%. increases "Ryn" proportionate to the decreased 'HP'. Upon defeating an enemy, recovers <val2>% of its power.	아홉 번째 위선, 이터 크루소/n대지 속성 <val0>, 연 피해를 입힙니다. 적을 처치하지 못했을 때마다 체력이 <val1>% 감소합니다. 감소한 체력의 비율만큼 연이 증가하며, 적 처치 시<val2>의 위력만큼 회복합니다.
EaelJonel	Eael Jonel	에엘 조넬
desc_EaelJonel	11th Conclusion, Eael Jornel/nIncreases range by <val0> and 'Armor Penetration' by <val1>%. Increases 'ATK' by the total 'SP' consumed by allied units during the current turn. Creates marks on the map with each attack, and standing on a mark allows this unit to obtain it. The number of obtained marks decreases by <val2> every <val3> turns.	열한 번째 결론, 에엘 조넬/n사정거리가 <val0> 증가하며, 방어관통력이 <val1>% 증가한다. 이번 턴 동안 아군 유닛이 총 소모한 SP만큼 공격력이 증가한다. 매 공격마다 맵 곳곳에 표식을 생성하며 표식에 올라서면 획득할 수 있다. 획득한 표식의 수 만큼 일반 공격 시 공격속도에 영향을 받지 않고 추가 공격을 한다. 획득한 표식 중첩은 <val3>턴마다 <val2>씩 감소한다.
Luneion	Luneion	루니온
desc_Luneion	7th Dawn, Luneion/nAttacks with the higher value between 'ATK' and 'RYN'. Regardless of distance, if the closest unit to the unit is an ally, it restores <val0>% of the damage dealt. If the closest unit is an enemy, it inflicts the same damage regardless of 'DEF' and 'RES'.	일곱 번째 새벽, 루니온/n공격력과 연 중 높은 수치의 피해량으로 공격한다. 대상으로부터 거리에 관계 없이 자신을 제외한 가장 가까운 유닛이 아군일 경우 피해량의 <val0>%만큼 회복시키며, 적군일 경우 방어력, 저항력과 관계없이 동일한 피해를 입힌다.
GorrmangDi	Gorrmang Di	고르망디
desc_GorrmangDi	10th Hunger, Gorrmang Di/nNormal attacks penetrate through enemies in a straight line. With each enemy penetrated, damage decreases by <val0>%, but if the HP of the <val1>-th enemy is less than Gormandi's power <val2> of attack damage, the damage is increased again by <val3>%.	열 번째 허기, 고르망디/n일반 공격시 직선상의 적을 관통하여 공격한다. 적을 관통할 때마다 피해량이 <val0>% 감소하며 <val1>번째 적의 체력이 고르망디의 위력 <val2>의 공격 피해량보다 적을 경우 다시 피해량이 <val3>% 증가한다.
CremRovan	Crem Rovan	크렘 로반
desc_CremRovan	13th Struggle, Crem Rovan/nReduces damage taken by <val1>% when the number of enemy units in adjacent <val0> tiles exceeds the number of allied units. If this unit loses 'HP' in battle, gains a shield equal to <val2>% of maximum 'HP'. While a shield is activated, Recovers <val3>% of the damage dealt, and this unit ables pass enemy.	열세 번째 투쟁, 크렘 로반/n자신의 인근 <val0>타일 내에 아군 유닛보다 적군 유닛의 수가 많을 경우 받는 피해량을 <val1>% 경감한다. 전투에서 체력을 잃을 경우 최대체력의 <val2>% 만큼의 보호막을 획득한다. 보호막이 활성화된 동안 모든 공격 피해량의 <val3>% 만큼 체력을 회복하며, 적 유닛을 통과할 수 있다.
Sunny	Sunny	맑음
desc_Sunny	'Earth Element' increased by <val0>%, 'Element' other than 'Earth Element' decreased by <val1>%, and 'CC' reduced by <val2>%.	대지 속성이 <val0>% 증가, 대지 이외의 속성이 <val1>% 감소, 상태이상이 <val2>% 감소한다.
Storm	Storm	폭풍
desc_Storm	Wind Element' increased by <val0>%, and every <val1> turns, a random area is struck by a storm of <val2>x<val2> (increases 'Evasion' by <val3>, pushed <val4> tiles in the opposite direction when stunned).	바람 속성이 <val0>% 증가하며, <val1>턴마다 무작위 지역에 <val2>x<val2>의 폭풍(회피 <val3> 증가, 기절 시 바라보는 방향의 반대로 <val4>칸 밀림)이 생성된다.
Electric Storm	Electric Storm	벼락 폭풍
desc_ElectriStorm	'Lightning Element' increased by <val0>%, 'Wind Element' decreased by <val1>%, and every <val2> turns, a random area is struck by a lightning bolt ('Paralysis' <val3>, 'Lightning Element' <val4>, fixed damage equal to <val5>% of maximum 'HP').	번개 속성이 <val0>% 증가, 바람 속성이 <val1>% 감소하며 <val2>턴마다 무작위 지역에 벼락(감전 <val3>, 번개 속성 <val4>, 최대체력의 <val5>%의 고정피해)이 내린다.
Heat Wave	Heat Wave	폭염
desc_HeatWave	'Fire Element' increased by <val0>%, 'Water Element' decreased by <val1>%, and 'Frost Element' decreased by <val2>%.	화염 속성이 <val0>% 증가, 물 속성이 <val1>% 감소, 얼음 속성이 <val2>% 감소한다.
Cold Wave	Cold Wave	한파
desc_ColdWave	Frost Element' increased by <val0>%, and 'SP' consumption increased by <val1>.	얼음 속성이 <val0>% 증가하며 SP 소모량이 <val1> 증가한다.
Rain	Rain	비
desc_Rain	All units are affected by the 'Wet'.	모든 유닛이 젖음 상태이상에 걸린다.
Snow	Snow	눈
desc_Snow	'Frost Element' increased by <val0>%, and every turn all units accumulate <val1> 'Frost Element'.	얼음 속성이 <val0>% 증가하며 매 턴마다 모든 유닛이 얼음 속성이 <val1> 누적된다.
Fog	Fog	안개
desc_Fog	Water Element' increased by <val0>%, 'Evasion' increased by <val1>, and for <val2> turns after 'Wind Element' attack, 'Accuracy' increased by <val3>.	물 속성이 <val0>% 증가하며 회피가 <val1> 증가하며 바람 속성 공격시 <val2>턴간 명중<val3> 증가한다.
Hail	Hail	우박
desc_Hail	'Frost Element' increased by <val0>%, and every <val1> to <val2> turns, hail ('Stun', 'Frost Element' <val4>, physical damage equal to <val5>% of maximum 'HP') falls on <val3> random locations.	얼음 속성 <val0>% 증가하며 <val1>~<val2>턴마다 무작위 지역에 <val3>곳에 우박(기절, 얼음 속성 <val4>, 최대 체력의 <val5>%의 물리피해)을 내립니다.
Insulation	Insulation	보온 
desc_Insulation	Increase 'Frost Resistance' by <val0>%.	 얼음 내성 <val0>% 증가
Radiating	Radiating	방열 
desc_Radiating	Increase 'Fire Resistance' by <val0>%.	 화염 내성 <val0>% 증가
Rage	Rage	분노 
desc_Rage	Increase "Atk" by <val0>% of lost 'HP'.	잃은 체력의 <val0>% 만큼 공격력 증가
Corner	Corner	궁지 
desc_Corner	Increase "Ryn" by <val0>% of lost 'HP'.	잃은 체력의 <val0>% 만큼 연 증가
Fortitude	Fortitude	불굴 
desc_Fortitude	Increase "Def" by <val0>% of lost 'HP'.	잃은 체력의 <val0>% 만큼 방어력 증가
Creed	Creed	신념 
desc_Creed	Increase "Res" by <val0>% of lost 'HP'.	잃은 체력의 <val0>% 만큼 저항력 증가
Superiority	Superiority	우세 
desc_Superiority	If the number of enemy units is fewer than friendly units, increase damage by <val0>%.	적 유닛의 수가 아군 유닛의 수보다 적다면 피해량 <val0>% 증가
Defiance	Defiance	반항 
desc_Defiance	If the enemy's attack count is higher than <val0>, perform <val1> additional attacks.	적의 공격횟수가 <val0>회 이상 높을 경우 <val1>회 추가 공격
Disguise	Disguise	가장 
desc_Disguise	If taking the least damage among the units the enemy can attack, designate <val0> unit as the target.	적이 공격 가능한 유닛 내에서 받는 피해량이 가장 낮을 경우, <val0> 유닛의 공격 대상으로 지정됨
Bluff	Bluff	허세 
desc_Bluff	If receiving the highest damage among the units the enemy can attack, do not designate <val0> unit as the target, unless there are no other friendly units within the enemy's attack range.	적이 공격 가능한 유닛 중 받는 피해량이 가장 높을 경우 <val0> 유닛의 공격 대상으로 지정되지 않음, 단 적의 공격 범위내에 자신만 있을 경우 발생되지 않음
ReMovement	ReMovement	재이동 
desc_ReMovement	After certain actions, able to move <val0> tiles.	일부 행동 이후 <val0> 타일 이동 가능
Learning	Learning	배움 
desc_Learning	Increase 'EXP' gained by <val0>%.	경험치 획득량 <val0>% 증가
Eclipse:Sol	Eclipse:Sol	이클립스(해) 
desc_Eclipse:Sol	All healing to me is fixed at <val0> and all attacks engrave a 'Sol' symbol on the target. When defeating an enemy with a 'Sol' symbol, increase 'ATK' by <val2>% for <val1> turns and gain invincibility <val3> times.	자신의 모든 체력회복이 <val0>으로 고정되며 모든 공격이 대상에게 태양의 문양을 새깁니다. 태양의 문양을 가진 적을 처치 시 <val1>턴간 공격력이 <val2>% 증가하며 무적 <val3>회를 얻습니다.
Eclipse:Luna	Eclipse:Luna	이클립스(달) 
desc_Eclipse:Luna	Most skills engrave a 'Luna' symbol on the target. Against enemies with a 'Luna' symbol, increase 'Defence Penetration' by <val0> and restore <val1> 'HP' for each friendly unit with a 'Luna' symbol after each action.	대부분의 기술이 대상에게 달의 문양을 새깁니다. 달의 문양을 가진 적을 대상으로 방어관통력이 <val0> 증가하며, 매 행동마다 달의 문양을 가진 아군의 수만큼 <val1>의 체력을 회복합니다.
Occurance	Occurance	점유 
desc_Occurance	Move to the tile where an enemy was defeated if it is possible.	적을 처치시 해당 타일로 이동이 가능한 경우 이동합니다.
Giganticism	Giganticism	거인의 형상
desc_Giganticism	Increase 'DEF' by <val1> when 'HP' is below <val0>%.	체력이 <val0>% 이하일 때 방어력이 <val1> 증가한다.
Master	Master	숙련가
desc_Master	This unit satisfies the requirements for all class changes.	모든 클래스의 전직 조건을 항상 만족시킨다.
Calling	Calling	부름
desc_Calling	When nearby allies attack, perform <val2> attacks with <val1>% damage within <val0> tiles.	인근 <val0>타일 이내의 아군이 공격 시 <val1>%의 피해량으로 <val2>회 공격
ThePower	ThePower	저력
desc_ThePower	Increase 'DEF', "RES" by <val1>% when 'HP' is below <val0>%.	체력이 <val0>% 미만일 경우 방/저 <val1>% 증가
EvadeStance	EvadeStance	회피자세
desc_EvadeStance	Increase 'Evasion' if a turn is passed without attacking by <val0>.	공격을 하지 않고 턴을 넘길 경우 회피가 <val0> 증가한다.
CrimsonGlare	CrimsonGlare	붉은 눈빛
desc_CrimsonGlare	Unit Bonus Damage' occur only during counterattacks but 'SPD' is reduced by <val0>%.	반격에 한해 특효가 발생하지만 속도가 <val0>% 감소한다.
Aura	Aura	아우라
desc_Aura	Increase 'RYN' by <val0> when defeating an enemy.	적을 처치할 때마다 연이 <val0> 증가한다.
Distortion	Distortion	왜곡
desc_Distortion	Increase the maximum range of all attacks by <val0>.	모든 공격의 최대사정거리가 <val0> 증가한다.
BreathControl	Breath Control	호흡참기 
desc_BreathControl	Ensure all attacks hit during the current turn.	해당 턴의 모든 공격을 반드시 명중시킨다.
Crater	Crater	크레이터 
desc_Crater	After attacking target, 'Stun' all nearby enemies within <val0> tiles.	대상을 공격한뒤 인근 <val0>타일 내에 있는 모든 적에게 기절 <val1>를 부여한다.
Requiem	Requiem	장송곡 
desc_Requiem	After defeating an enemy with the specific skill, 'Silence' all enemies within <val0> tiles.	해당 기술로 적을 처치시 <val0>타일 내의 모든 적에게 침묵 <val1>을 부여한다.
EventHorizon	Event Horizon	사건의 지평선 
desc_EventHorizon	Pull the enemy with the lowest 'HP' among all enemies within <val0> tiles of all void orbs on the map and deal damage.	맵 상 존재하는 모든 공허의 구슬의 <val0>타일 내에 있는 적들 중 체력이 가장 낮은 적을 공허의 구슬로 빨아들여 피해를 입힌다.
RyeonCoreAnnihilation	RyeonCore Annihilation	연핵 파괴 
desc_RyeonCoreAnnihilation	Deal damage to the target and decrease 'RYN' by <val1>% for <val0> turns.	대상에게 피해를 입히고, <val0>턴간 연을 <val1>% 감소시킨다.
ForbiddenCurse	Forbidden Curse	금기된 저주 
desc_ForbiddenCurse	Place a curse on the designated target until the end of the battlefield. The curse inflicts <val0> damage to my 'HP' per turn and deals <val1>% damage to the target whenever they take action. If the target is defeated, restore <val2> 'HP'.	대상을 지정해 전장이 끝날 때까지 저주를 건다, 저주는 매 턴당 내 체력을 <val0> 감소시키며, 대상이 행동을 할 때마다 <val1>%의 피해를 입힌다. 대상이 처치될 경우 체력을 <val2>회복한다.
HalfSpiritReplication	HalfSpirit Replication	반혼 복제 
desc_HalfSpiritReplication	If not equipped a 'Half Spirit', replicate the target's 'Half Spirit' and use it. If unit is setted 'Half Spirit', acquire the corresponding 'Half Spirit' in the inventory until the end of the battlefield.	반혼을 장착하지 않았을 경우 대상의 반혼을 복제하여 착용한다, 자신이 반혼술사일 경우 전장이 끝날 때까지 인벤토리에 해당 반혼을 획득한다.
Sniper	Sniper	저격수
desc_Sniper	A lone sniper in distant places.	홀로 먼 거리에서 적을 사살하는 자.
Destroyer	Destroyer	디스트로이어
desc_Destroyer	A formidable striker who shatters formations with a powerful blow.	강력한 일격으로 진형을 무너뜨리는 자.
DeadHunter	Dead Hunter	망자사냥꾼
desc_DeadHunter	A hunter of wandering spirits.	떠돌이 망자들을 사냥하는 자.
Guardian	Guardian	수비병
desc_Guardian	One who strengthens themselves to protect.	지키기 위해 힘을 기른 자.
Watcher	Watcher	감시자
desc_Watcher	A vigilant watcher.	감시하는 자.
Gigantic	Gigantic	기간틱
desc_Gigantic	One who possesses the strength of giants.	거인과 같은 힘을 지닌자.
WaveRyeonier	Wave Ryeonier	물결술사
desc_WaveRyeonier	One who manipulates the flow of 'Ryeon' like flowing waves.	흐르는 물결처럼 연의 흐름을 다루는 자.
VoidRyeonier	Void Ryeonier	공허술사
desc_VoidRyeonier	One who wields the connection between void and 'Ryeon'.	공허와 연을 이어 다루는 자.
Acrobat	Acrobat	아크로바트
desc_Acrobat	One who deceives enemies with dazzling maneuvers.	화려한 몸 놀림으로 적을 농간하는 자.
Spearyeonier	Spearyeonier	연창사
desc_Spearyeonier	One who wields the power of 'Ryeon' and spear.	연술의 힘과 창을 다루는 자.
CrisomDawn	Crisom Dawn	크림슨던
desc_CrisomDawn	One who wields the crimson power of 'Ryeon' and blunt.	붉게 물든 연의 힘과 둔기를 다루는 자.
CurseRyeonier	Curse Ryeonier	저주술사
desc_CurseRyeonier	One who practices cursed 'Ryeon.	저주의 연술을 다루는 자.
HalfSpiritRyeonier	HalfSpirit Ryeonier	반혼술사
desc_HalfSpiritRyeonier	One who wields the power of 'Ryeon' through bonds.	연의 힘으로 반혼을 다루는 자.
Swordyeonier	Swordyeonier	연검사
desc_Swordyeonier	One who wields the power of 'Ryeon' and sword.	연술의 힘과 검을 다루는 자.
Jupiter	Jupiter	유피테르
desc_Jupiter	One who attacks enemies from a distance with an sword of 'Ryeon'.	연의 검으로 멀리서도 적을 공격하는 자.
Inwarder	Inwarder	내적자
desc_Inwarder	One who destroys the inner being of foes.	적의 내부를 파괴하는 자.
TheWall	TheWall	거벽
desc_TheWall	One who stands as a colossal wall to block enemies.	거대한 벽과 같이 적을 가로막는 자.
Thief	Thief	도적
desc_Thief	One who swiftly plunders the wealth of enemies.	재빠른 움직임으로 적의 금화를 터는 자.
DreamyRyeonier	Dreamy Ryeonier	몽환술사
desc_DreamyRyeonier	One who confuses enemies with dream-like illusions.	꿈같은 환상으로 적을 교란시키는 자.
MysticRyeonier	Mystic Ryeonier	신비술사
desc_MysticRyeonier	One who captivates enemy attention with 'Ryeon' connected to death.	죽음과 연결된 연으로 적의 이목을 집중 시키는 자.
desc_skill_Swordsman	None	없음
desc_skill_SwordMaster	Increases 'ATK' by <val0> when equipped with a sword.	검 장착시 공격력 <val0>증가
desc_skill_SwordDeity	Increases 'SPD', DEX' by <val0> when equipped with a sword.	검 장착시 속도 재주 <val0>증가
desc_skill_Fighter	Increases 'SPD', DEX' by <val0> when attacked.	공격을 받을 경우 속도 <val0>증가
desc_skill_Asura	If there are <val1> or more enemies within adjacent <val0> tiles, increases 'ATK' by <val2>.	인근 <val0>타일 내에 적이 <val1>명 이상일 경우 공격력 <val2>증가
desc_skill_Soldier	If there are <val1> or more allies within adjacent <val0> tiles, applies <val2>% 'Class EXP'.	인근 <val0>타일 내에 아군이 <val1>명 이상일 경우 숙련도 <val2>% 적용
desc_skill_EliteSoldier	If there are <val1> or more allies within adjacent <val0> tiles, applies <val2>% 'Class EXP'.	인근 <val0>타일 내에 아군이 <val1>명 이상일 경우 숙련도 <val2>% 적용
desc_skill_General	If there are more enemy units than allied units, increases all allies' 'DEF', "RES" by <val0>. If there are more allied units than enemy units, increases all allies' 'Atk, 'RYN' by <val1>.	아군보다 적군이 많을 경우 모든 아군의 방어력, 저항력 <val0>증가, 아군이 적군보다 많을경우 모든 아군의 공격력 연 <val1>증가
desc_skill_Hunter	Triggers a 'Unit Bonus Damage' when the enemy's 'HP' is below <val0>%.	상대의 체력이 <val0>% 이하일 경우 특효 발생
desc_skill_Assassin	If there are no enemy units within <val0> tiles of the target, increases 'ATK' by <val1>.	상대 인근 <val0>타일 내에 적군이 존재하지 않을 경우 공격력 <val1>증가
desc_skill_Paladin	Increases 'RES' by <val0>.	저항력 <val0>증가
desc_skill_Ryeonier	None	없음
desc_skill_HealRyeonier	Restores <val0> 'SP' to the corresponding ally upon recovery.	회복시 해당 아군의 기력 <val0>회복
desc_skill_WhiteRyeonier	Attacks <val1> enemies within adjacent <val0> tiles when recovering.	회복시 인근 <val0>타일의 적군 <val1>명 공격
desc_skill_BlackRyeonier	Restores 'HP' to <val1> allied units within adjacent <val0> tiles when attacking.	공격시 인근 <val0>타일의 아군 <val1>명 회복
desc_skill_SoulRyeonier	Obtain the soul when defeating an enemy.	적을 처치시 영혼을 획득 가능
desc_skill_LivingSoulRyeonier	Acquire the enemy's soul by targeting a living target.	살아있는 대상으로 상대의 영혼 획득 가능
desc_skill_NecroRyeonier	Acquire the soul when the last attacked target is defeated.	마지막으로 공격한 대상이 처치될 경우 영혼 획득 가능
desc_skill_NaturalRyeonier	Increases 'Class EXP' by <val0>% in forest terrain.	숲 지형에서 숙련도 <val0>%증가
desc_skill_FlameRyeonier	Increases 'RYN' by <val0>.	연 <val0>증가
desc_skill_FrostRyeonier	Applies higher of 'Def or Res' based on the type of damage received.	상대의 피해 형태에 따라 방어력 저항력 중 높은 스탯으로 적용됨
desc_skill_LightningRyeonier	Transfers <val0>% of the base attack damage to all adjacent enemies.	인접해 있는 모든 적이 기본공격의 <val0>%의 피해량이 전이됨
desc_skill_StormRyeonier	Changes weather for <val0> turns depending on the used 'Ryeon' skill.	사용하는 연술에 따라 <val0>턴간 날씨 변경
desc_skill_EarthRyeonier	Adds <val0> additional normal attacks to the target equipped with a 'Half Spirit'.	반혼을 장착한 대상을 상대에게 기본 공격 <val0>회 추가
desc_skill_CaptainOfTheMercenaries	Increases 'EXP' gained by <val0>%.	경험치 획득량 <val0>% 증가
desc_skill_DivineMadien	Immediately brings back the turn of the designated ally.	지정한 아군의 턴을 즉시 불러온다
desc_skill_TheKing	Reduces enemy unit's 'Atk, Ryn' by <val1>% within <val0> tiles.	<val0>칸 이내의 적 유닛의 공격력, 연 <val1>%감소
desc_skill_Hero	Allows <val1> additional actions upon defeating an enemy for every <val0> turns.	턴당 <val0>회에 한해 적을 처치시 <val1>회 추가 행동가능
desc_skill_LostWings	Restores <val2>% 'HP' when 'HP' reaches <val1> for every <val0> turns.	매 전투마다 <val0>회에 한해 체력이 <val1>이 될 경우 <val2>%의 체력 회복
desc_skill_TheDivine	Restores <val2>% 'HP' when 'HP' reaches <val1> for every <val0> turns.	매 전투마다 <val0>회에 한해 체력이 <val1>이 될 경우 <val2>%의 체력 회복
desc_skill_Sniper	Increases 'ATK' by <val1> if there are no enemy units within <val0> tiles of the target.	대상의 <val0>타일 내에 적 유닛이 없을 경우 공격력 <val1>증가
desc_skill_Destroyer	Inflicts <val1>% damage to enemies within the target's adjacent <val0> tiles with normal attacks.	기본 공격시 대상의 인근 <val0>타일 내에 있는 적에게 <val1>%의 피해 발생
desc_skill_DeadHunter	Increases damage to non-human targets by <val0>%.	인간 이외의 대상에게 피해량 <val0>% 증가
desc_skill_Guardian	Increases 'DEF' by <val0>.	방어력 <val0> 증가
desc_skill_Watcher	Reduces the target's 'Evasion' by <val0> upon dealing damage.	피해를 입힌 대상의 회피가 <val0>감소
desc_skill_Gigantic	Applies an additional fixed damage of <val0> to all damage dealt.	모든 피해가 <val0>의 추가 고정피해를 입힌다
desc_skill_WaveRyeonier	Increases 'RES' by <val1>% if there are Ryeon-class professions within <val0> tiles.	인근 <val0>타일 내에 연술사 계열의 클래스가 존재할 경우 저항력 <val1>% 증가
desc_skill_VoidRyeonier	Places Void Beads upon defeating enemies; enemies in contact with Void Beads have reduced resistance to all 'CC' ailments by <val0>.	적 처치시 공허의 구슬을 배치, 공허의 구슬에 닿은 적은 모든 상태이상 내성이 <val0> 감소한다
desc_skill_Acrobat	Increases 'Evasion' for the current turn by <val0> when defeating an enemy.	적을 처치시 해당 턴의 회피가 <val0> 증가한다.
desc_skill_Spearyeonier	Converts <val0>% of all damage to 'Ryeon' damage.	모든 공격의 <val0>%가 연 피해로 전환된다.
desc_skill_CrisomDawn	Increases 'Unit Bonus Damage' by <val0>%.	특효피해량이 <val0>% 증가한다.
desc_skill_CurseRyeonier	Increases accumulated 'CC' ailment stacks on targets affected by 'CC' ailments by <val0>.	상태이상에 걸린 대상에게 상태이상 누적이 <val0> 증가한다.
desc_skill_HalfSpiritRyeonier	Can equip <val0> 'Half Spirit' and can switch 'Half Spirit' during battles.	반혼을 <val0>개 착용할 수 있으며, 전투 중 반혼을 교체할 수 있다.
desc_skill_Swordyeonier	The equipped weapon's damage type is combined with 'ATK' or 'RYN'.	장착한 무기의 피해타입에 따라 공격력 혹은 연이 합산된다.
desc_skill_Jupiter	Counters with 'Lightning' <val0> when receiving physical attacks and can counter regardless of distance when receiving 'Ryeon' attacks.	물리타입의 공격을 받을경우 반격에 번개 속성 <val0>, 연술타입의 공격을 받을 경우 거리에 관계없이 반격을 할 수 있다.
desc_skill_Inwarder	Cumulative damage is recorded but does not reduce the enemy's 'HP'. If the accumulated damage exceeds the enemy's remaining 'HP', performs <val0> additional actions.	적을 공격시 피해량은 누적되지만 적의 체력은 감소하지 않는다. 누적된 피해량이 적의 남은 체력보다 높을 경우 <val0>회 추가 행동을 한다.
desc_skill_TheWall	Gains a shield of <val0>% of maximum 'HP' every turn.	매 턴마다 최대체력이 <val0>%의 보호막을 획득한다.
desc_skill_Thief	Obtains gold upon dealing damage to enemies.	적에게 피해를 입힐 때마다 골드를 획득한다.
desc_skill_DreamyRyeonier	Creates a shield equal to the target's remaining 'HP' if the damage exceeds maximum 'HP'. The shield dissipates at the end of the battle.	최대 체력 이상의 피해를 입게될 때 대상의 남은 체력만큼의 보호막을 생성한다. 전투가 종료되면 보호막은 소멸한다.
desc_skill_MysticRyeonier	Initiates a normal attack if there are no enemy units within <val0> tiles of the target.	인근 <val0>타일 내에 적의 체력이 <val1>% 이하일 경우 기본공격을 가한다.
desc_unlock_Swordsman	None	없음
desc_unlock_SwordMaster	None	없음
desc_unlock_SwordDeity	Wins in swordsmanship duels.	검술 대련회를 우승한다.
desc_unlock_Fighter	Reaches the top 4 in martial arts tournaments.	무술 대련회를 4강 진출한다.
desc_unlock_Asura	None	없음
desc_unlock_Soldier	None	없음
desc_unlock_EliteSoldier	None	없음
desc_unlock_General	None	없음
desc_unlock_Hunter	None	없음
desc_unlock_Assassin	Evade the enemy's attacks 10 times.	적의 공격을 10회 이상 회피한다.
desc_unlock_Paladin	None	없음
desc_unlock_Ryeonier	None	없음
desc_unlock_HealRyeonier	None	없음
desc_unlock_WhiteRyeonier	Accumulates healing over 100.	누적 회복량이 100을 넘는다.
desc_unlock_BlackRyeonier	Accumulates damage received over 100.	누적 피해량이 100을 넘는다.
desc_unlock_SoulRyeonier	Clears the "The Tomb" stage.	'무덤' 스테이지를 클리어한다.
desc_unlock_LivingSoulRyeonier	Defeats enemies while the effect of "Funeral Rites" is active.	'장례'의 효과가 발동된 동안 적을 처치한다.
desc_unlock_NecroRyeonier	Recovers allies while the effect of "Funeral Rites" is active.	'장례'의 효과가 발동된 동안 아군을 회복한다.
desc_unlock_NaturalRyeonier	Defeats enemies with the 'RYN' attack in forest terrain.	숲 지형에서 연술로 적 처치
desc_unlock_FlameRyeonier	Defeats enemies with 'Burn' damage.	화상 피해로 적을 처치한다.
desc_unlock_FrostRyeonier	Defeats enemies with 'RES' of 20 or higher.	저항력이 20 이상인 적을 처치한다.
desc_unlock_LightningRyeonier	Encounters a lightning storm weather.	벼락 폭풍 날씨를 조우한다.
desc_unlock_StormRyeonier	Encounters a storm weather.	폭풍 날씨를 조우한다.
desc_unlock_EarthRyeonier	Recovers 'HP' by more than 20 with a single recovery.	한 번의 회복으로 체력을 20 이상 회복한다.
desc_unlock_CaptainOfTheMercenaries	Clears the stage of "Maiden of FirstGod."	'초대신의 신녀' 스테이지를 클리어한다.
desc_unlock_DivineMadien	None	없음
desc_unlock_TheKing	None	없음
desc_unlock_Hero	None	없음
desc_unlock_LostWings	None	없음
desc_unlock_TheDivine	Obtains the 'Dew of Silent'.	고요의 이슬을 취득한다.
desc_unlock_Sniper	Defeats enemies located 2 tiles away 5 times.	2타일 떨어진 적을 5번 처치한다.
desc_unlock_Destroyer	Destroys objects 5 times.	오브젝트 5회 파괴한다.
desc_unlock_DeadHunter	Defeats 'Soul Ryeonier' 3 times.	영혼술사를 3회 처치한다.
desc_unlock_Guardian	Accumulates damage received over 100.	누적 받은 피해량이 100을 넘는다.
desc_unlock_Watcher	Defeats high 'Evasion' enemies with an 'Accuracy' card.	회피가 높은 적을 명중카드로 처치한다.
desc_unlock_Gigantic	Obtains the 'Half Spirit' of the "One Horned Giant."	'외뿔 거인'의 반혼을 획득한다.
desc_unlock_WaveRyeonier	'Ryeonier' take 'Ryeon' damage in fog weather.	안개 날씨에서 연술사 클래스 계열이 연술 피해를 받는다.
desc_unlock_VoidRyeonier	Accumulates more than 30 kills.	누적 처치가 30을 넘는다.
desc_unlock_Acrobat	Wields a spear with a 'SPD' exceeding 30.	창을 든채로 속도가 30을 넘는다.
desc_unlock_Spearyeonier	Uses a spear that deals 'Ryeon' damage.	연술 피해를 입히는 창을 사용한다.
desc_unlock_CrisomDawn	Defeats 5 or more enemies with 'Ryeon' weapons.	둔기로 적을 5명 이상 처치한다.
desc_unlock_CurseRyeonier	Removes 'CC' ailments from allies.	아군의 상태이상을 제거한다.
desc_unlock_HalfSpiritRyeonier	Obtains 10 'Half Spirit'.	반혼을 10개 획득한다.
desc_unlock_Swordyeonier	Uses a sword that deals 'Ryeon' damage.	연술 피해를 입히는 검을 사용한다.
desc_unlock_Jupiter	Counters 100 times while equipped with a 'Ryeon' weapon.	연술 무기를 장착한 채로 반격을 100번 한다.
desc_unlock_Inwarder	Defeats enemies with 100% 'HP' 30 times.	HP가 100%인 적을 30회 처치
desc_unlock_TheWall	Takes damage and survives 3 times with more than 10% 'HP'.	HP가 10% 이상인 경우 피해를 받고 3번 생존을 한다.
desc_unlock_Thief	Achieves accumulated gold of 10,000.	누적 골드 10,000을 달성한다.
desc_unlock_DreamyRyeonier	Evades attacks exceeding maximum 'HP' 10 times.	최대체력 이상의 피해를 10회 회피한다.
desc_unlock_MysticRyeonier	Defeats enemies 20 times when there are allies within 3 tiles.	3타일 내에 아군이 존재할 때, 적을 20회 처치한다.
desc_deserve_Swordsman	None	없음
desc_deserve_SwordMaster	Swordsman 'Class EXP' 100	검사 숙련도 100
desc_deserve_SwordDeity	Swordsman 'Class EXP' 100	검사 숙련도 100
desc_deserve_Fighter	None	없음
desc_deserve_Asura	Fighter 'Class EXP' 100	투사 숙련도 100
desc_deserve_Soldier	None	없음
desc_deserve_EliteSoldier	Soldier 'Class EXP' 100	병사 숙련도 100
desc_deserve_General	Elite Soldier 'Class EXP' 100	정예병 숙련도 100
desc_deserve_Hunter	None	없음
desc_deserve_Assassin	None	없음
desc_deserve_Paladin	Elite Soldier 'Class EXP' 70	정예병 숙련도 70
desc_deserve_Ryeonier	None	없음
desc_deserve_HealRyeonier	Ryeonier 'Class EXP' 65	연술사 숙련도 65
desc_deserve_WhiteRyeonier	None	없음
desc_deserve_BlackRyeonier	Heal Ryeonier 'Class EXP' 80	회복술사 숙련도 80
desc_deserve_SoulRyeonier	Ryeonier 'Class EXP' 80	연술사 숙련도 80
desc_deserve_LivingSoulRyeonier	SoulRyeonier 'Class EXP' 60	영혼술사 숙련도 60
desc_deserve_NecroRyeonier	SoulRyeonier 'Class EXP' 55	영혼술사 숙련도 55
desc_deserve_NaturalRyeonier	Ryeonier 'Class EXP' 80	연술사 숙련도 80
desc_deserve_FlameRyeonier	Natural Ryeonier 'Class EXP' 55	자연술사 숙련도 55
desc_deserve_FrostRyeonier	Natural Ryeonier 'Class EXP' 60	자연술사 숙련도 60
desc_deserve_LightningRyeonier	Natural Ryeonier 'Class EXP' 55	자연술사 숙련도 55
desc_deserve_StormRyeonier	Natural Ryeonier 'Class EXP' 60	자연술사 숙련도 60
desc_deserve_EarthRyeonier	Natural Ryeonier 'Class EXP' 80	자연술사 숙련도 80
desc_deserve_CaptainOfTheMercenaries	Kain / Kana	카인 / 카나
desc_deserve_DivineMadien	Elrtra	엘르트라
desc_deserve_TheKing	Herwin	헤르윈
desc_deserve_Hero	Nonamed Hero	무명용사(니아)
desc_deserve_LostWings	Hiyanne	히얀느
desc_deserve_TheDivine	Hiyanne	히얀느
desc_deserve_Sniper	None	없음
desc_deserve_Destroyer	None	없음
desc_deserve_DeadHunter	None	없음
desc_deserve_Guardian	Solider 'Class EXP' 60	병사 숙련도 60
desc_deserve_Watcher	None	없음
desc_deserve_Gigantic	None	없음
desc_deserve_WaveRyeonier	Ryeonier 'Class EXP' 70	연술사 70
desc_deserve_VoidRyeonier	Black Ryeonier 'Class EXP' 90	흑연술사 90
desc_deserve_Acrobat	Spd' 25	속도 25
desc_deserve_Spearyeonier	RYN' 15	연 15
desc_deserve_CrisomDawn	None	없음
desc_deserve_CurseRyeonier	White Ryeonier  'Class EXP' 80	백연술사 80
desc_deserve_HalfSpiritRyeonier	None	없음
desc_deserve_Swordyeonier	Swordsman 'Class EXP' 75	검사 75
desc_deserve_Jupiter	Sword Master 'Class EXP' 85	소드마스터 85
desc_deserve_Inwarder	Hunter 'Class EXP' 100	사냥꾼 100
desc_deserve_TheWall	Guardian 'Class EXP' 70	수비병 70
desc_deserve_Thief	None	없음
desc_deserve_DreamyRyeonier	White Ryeonier 'Class EXP' 85	백연술사 85
desc_deserve_MysticRyeonier	Black Ryeonier 'Class EXP' 80	흑연술사 80
